111111111111
1000C00000E1
110101111101
110101111101
100000000CC1
100100011101
100100000001
100100000001
100110111101
100110111101
10C00C000001
10110C0000C1
1C1100111101
10CC000P0001
101100111101
100000000C01
111111111111