111111111111111111
10000000E000000011
100111111111111011
100C0000P001111011
100000000101111011
101111100000000001
101111100101111001
101111100101111001
101111100101111001
100000000000011001
1011111001010110C1
101111100101011001
100001100101000001
101101100000000001
100001101101110001
100000000001110101
100101101001110101
10C00000000C0C0001
111111111111111111