111111111
1000000E1
100111111
1C0111111
100111111
100000111
1C0110111
100110111
100110111
100110111
100000001
10011C101
10011C1C1
100110101
10P1101C1
1011100C1
100000001
1C1111101
101111101
1C1111101
1000C0001
111111111