1111111111111111111
100000000E000000001
101110000000C000001
1011100000000000001
10C0000001111101101
1001101011111101101
10011C0P00C00000001
1001101C11111101101
1C01101011111101101
1001101011111101101
1000000000000000001
100110C0000001C1101
1000101111010101101
1C00101111010101101
1000000000000000001
1111111111111111111