1111111111111111111
1000C0000C00CC00E01
1001011P00101111011
10000C10111C1111011
1011C010111C1111011
1011011011101111011
10C00CC000C00000001
1111111111111111111