1111111111111111
1EC000C000000001
1010101101111101
100000C000000001
1010101101000001
1000000000001101
10000C010110C001
1010110101111101
1000000000000001
1010000111111101
1C11111111111111
1011111111111111
1000000000111111
111111110P111111
1111111100111111
1111111111111111