11111111111111111111111
100C0000000000000000001
1011111011111C010111101
10011110111110010000001
10011110111110010111101
10011110111110000111101
10000000111111010111101
10000000C0000P010111101
1001111110000C010111101
10000011101110010111101
10011011101110010111101
10C10000000010010111101
10000000101010010111101
100000000000C000E0C0001
11111111111111111111111