1111111111111111111
1E000000000000C0001
1011010011110111101
10110100P0000000001
1010000000000000101
101C0100C1110110001
101C010001110110001
1000010001110110001
1000000000000110001
1000110001101110001
1000110001101110001
1000110000000000001
10001100000C0000001
10001111C1101111001
1000000001101111001
1000111101101111001
1000111101101111001
1C001111011011110C1
1001111101101111001
1001111101101111001
1000C00000000000001
1111111111111111111