11111111111111
1000C000001111
1011C1111C1111
10110000000001
10111111101101
100001111011C1
101101111000C1
1C0P0000000101
10100111100101
10000000000101
100000C0000001
10100C00000001
101C0000000101
1000001111C101
10100C00000001
100000000000E1
11111111111111