1111111111111111111
10000C000C000000001
1011110001110000CC1
1011110001110111001
1000010001110111011
1000000000010111011
100101000101P111011
10010100C0000000001
1000CC0000011111001
10110101C0011111001
1C00010000C00000C01
10000000C000000E001
1111111111111111111