11111111111111111111
1000C011111000C00001
100110111110C1110001
1P0E00000000011111C1
10011011111001111101
100C000000000C000001
11111111111111111111