111111111111111
100C000C0000001
100011011110001
100011000000001
100000000000001
101011C111100C1
101011011110001
101C11011110001
101011011110001
100000011110001
1010110C00C0001
101011111110001
1010111P11100C1
10100000C000001
101001101110101
101C00000000101
1000000E0000001
111111111111111