111111111111111111
1000C0000000000CC1
10001110C110011001
101C11100110C11001
101000C000P0011001
1C1111100110011C01
1011111001110110C1
101110000000000CE1
111111111111111111