111111111111111111111111
100000000000000000000NE1
101111101111100000000001
100000000000000N00000001
101111111111100010001101
1C1111111111100000001101
1011111111111C0000N00001
101111111111100000000001
1C1111111111100011001101
101111111111100P11001101
100000000011100111001101
101111111011100111000001
1011111110111C0111101101
101111111011100000000001
101111111011110C000N0001
1000000C00000000N0000001
111111111111111111111111