1111111111111111
1E000C0000PP0001
1001100C00000C01
1001101000101111
10011C10C01C1111
10C000000C101111
1000C0CC00000001
1111111111111111