1111111111111111
1E0000000P000001
1001100000000001
1001101000101111
1001101010101111
1000000001101111
1000000000000001
1111111111111111