1111111111111111
1000C0E000000001
1011111110111101
1011111110111101
10111111101111C1
1011111110CC0001
1011111111111001
1011111111111001
1C11111111111001
1011111111111001
1011111111111001
1000C00P00000001
1001111C11111011
1001111011111011
1001111011111001
1001111011111101
1001111011111101
1000000000000001
1000000000000001
1111111111111111