111111111
11C000001
100000001
1C0000101
1001001C1
1001001E1
10C0CC001
10110C101
10110P1C1
10C000101
101000101
1000001C1
101010001
10101C001
100011101
100000001
100000001
111111111