11111111111111111
1000C000PC00E0001
1C001011011101101
10001011011101101
10001000011100C01
1C000000011111101
11111111111111111