11111111111
1E0000C0001
10110111101
10110111101
10000111101
10C00000C01
10100101101
1010C101101
10100000001
10100101101
10000C011C1
1C101001101
10101001101
10101001101
10P00C00001
10101011101
10101011101
10000000001
11111111111