1111111111111111111
10P0000000000000001
1C11111111101101101
10111111111011C1101
1011111111101101101
101111111110100C001
1000C0C111101C00001
1011110111101000001
1C11110111101000C01
1E11110111101000001
1000010111101001C01
10010101111C1001001
1001C101111010010C1
1000000000000000001
1111111111111111111