111111111111
1000C000C001
100000C00C01
100110111001
101110100C01
10P000001C01
10C000C0C001
101011111C01
101011111001
101C11111C01
1E0000000001
111111111111