1111111111111
11CC0CC000E01
1101101010001
110110C0PC001
1000C01000001
1CC11000000C1
1111111111111