111111111111111111
1C00000000000000E1
1P0010011111101111
100010000C01101111
100000000000000111
1000110111011C0111
10C000000000000111
101011111101100111
10000000000110C001
111111111111111111