1111111111111111
10001111110C00C1
101C111111C10101
10101111110101P1
1010111111010101
10C00ECC00000001
1111111111111111