11111111111
100000000C1
101111000P1
10111101101
101111011E1
10111101111
10111101111
10111101111
10001101111
101011C1111
101011C1111
10100000011
10100C01011
100C0001C11
10111001001
101110C11C1
1C1110111C1
1C000000001
10000C00001
11111111111