111111111111111111
100000P00C00000001
101111111111111001
101111111111111001
101111111111111C01
101111111111111001
100000000000000001
10000000000C000001
101011111101111001
101C111111C1110001
1010111111C1110001
101011111101110001
101011111100000001
101011111111110001
10100000C000000001
1000000000000000E1
111111111111111111