111111111111111111111111
1000000P0000000000000001
100001010100111111011101
1E0001010100111111011101
100000000000100000000001
10000C000001101111011101
1000000C00000CC000000001
111111111111111111111111