1111111111111111111111
1000000000000000000001
1011111111101011010101
1011111111101011010101
1011111111101011010101
1011111111E00C00000001
1011111111101001000101
1000000000000001000101
1111111111101101000101
100000000P000000000001
1011111110111101100101
10111111101111C1100101
1000000000001101100101
101111111C101101100101
1011111110100000000101
1011111110000000000001
1011111111100101100101
1011111111100101100101
10111111111001011001C1
1C00000000000001100101
1000000000000000000001
1111111111111111111111