11111111111
1C000000001
10111111111
10111111111
10111111111
10000000001
10000001101
10C001011E1
10110101101
10000000001
10110100101
100000001C1
10110000101
10000000P01
100000111C1
10000000001
11111111111