111111111
100C11111
100C11111
10000E111
1000P0011
100100001
100100001
1C00000C1
111111111