111111111111111111
1C000C000000C000C1
1000011110011C1101
101001111C011C1101
1000000C1C01101101
100000P000CC001101
1E000000000000C001
111111111111111111