111111111111111111
100000000000000001
100110110110011101
100110110110011101
100110000000000001
100000000000001101
100000000000000001
100000000010001101
101111110110001101
1C0000000000001101
1011101111110011C1
101110111111E01101
101110111000000001
101110111011P00101
101110111011100101
101110111011100101
101110111011100101
101110111011100101
101110111011100101
1000000000C0000001
1C00000000000000C1
111111111111111111