111111111111111111
100011000000000E01
101011111110011001
1010111111100110C1
101011111110C11001
1P00000000000C0001
101001111110011001
101001110000000001
101001110110011001
1000011101100110C1
10000111C110C00001
10C000000000011101
100010110110111101
100010000000001101
100C00000000000001
100110110011111101
100000000011111101
100110000000C00001
111111111111111111