1111111111111111
1E000000000000C1
1000000000000001
1000000000011101
1011101111111101
1011101111111101
1011101111111101
10111C1111111101
10111C1111111101
1011100011111101
1011111011111101
1C00000000000001
1011111011111101
10000CC0000C0C01
1011P00C00000001
1011111011110101
1011110000000001
1011110011110111
10110CC011110111
1000000C00000111
1111111111111111