111111111111111
1E0000000000001
101011111111101
100000001111001
100011101000001
10001110P011001
100011100011001
100011100011001
100000000000001
1C0111100011101
100000000000001
100111100011101
100111100011101
1000C0000011101
10011100C011101
1000000000000C1
111111111111111