111111111111111111
100E000000000CC001
100000010011111101
101110110C11111101
10111011C011111101
101110110011111101
101110110011111101
1011100000000C00P1
1000000C00000C0001
111111111111111111