11111111111111
1000C00CC11111
1P110001011101
11110001011C01
10C000C1011001
101110010110C1
10111001011001
10111001011001
1E0C0C0CC00001
11111111111111